NO ./src/textures/2.png
SO ./src/textures/3.png
WE ./src/textures/4.png
EA ./src/textures/5.png
MU ./src/textures/mushr.png
MU2 ./src/textures/mushr2.png
MUM ./src/textures/mushr_map.png
DO0 ./src/textures/13.png
DO1 ./src/textures/14.png
DO2 ./src/textures/15.png
PS1 ./src/textures/psy1.png
PS2 ./src/textures/psy2.png
PS3 ./src/textures/psy3.png


F  220,100,0
C 225,30,0

        1111111111111111111111111
        1000000000110000000000001
        10110000011100000N0000001
        100100000000MMM0000000001
111111111011000001110000000000001
100000000011000001110111111111111
11110111111111011100000010001
11110111111111011101010010001
11000000110101011100000M10001
100MMMMM000000001100000010001
10000000000000001101010010001
110M0M0111010101111101111000111
11110111 1110101 101111010001
11111111 1111111 111111111111



