NO ./src/textures/2.png
SO ./src/textures/3.png
WE ./src/textures/4.png
EA ./src/textures/5.png
MU ./src/textures/mushr.png
MU2 ./src/textures/mushr2.png
MUM ./src/textures/mushr_map.png
DO0 ./src/textures/13.png
DO1 ./src/textures/14.png
DO2 ./src/textures/15.png
PS1 ./src/textures/psy1.png
PS2 ./src/textures/psy2.png
PS3 ./src/textures/psy3.png

C 91,166,252
F 224,184,144

111111111111 111111111111111
100000000001 11000E000000001
1000000000011100000000001111
1000000000000010100000001
110000000000011010000000111111
10000000     00000000000000001
10000000     000000000000000011111
100000000000000000000000111111
1000000000000000000000001
1000000000000000000000001
1111111111111111111111111
