NO ./src/textures/Bricks_07-128x128.png
SO ./src/textures/DarkAbstractBackgrounds_06.png
WE ./src/textures/DarkAbstractBackgrounds_09.png
EA ./src/textures/DarkAbstractBackgrounds_010.png


F  220,100,0
C 225,30,0

1111111111111111111111111111
1110010011110100100000111001
1111111100011111111111111111
1110011111111011001110100011
1110100001001001010011001001
1111001111010000110100100101
1110110010101000000000100111
1110110010101000000000100111
1110110010101000000000100111
1110110010101000000000100111
1110000101000100000001000011
1110000101000100000001000011
1110000101000100000001000011
1110000101000100000001000011
1100100010100010000010010011
1100100010100010000010010011
1100100010100010000010010011
1100100010100010000010010011
1110010100010110000111000111
1101110010011000010010100111
1100110101000100100000110011
1110100010000100011000011011
1101001100100010000010001111
1100110010001011000000001011
1110000101000010100000100011
1100100010100001010000000011
1110010100110000000010000011
110110001000100N000110000011
1100010101000100010000000011
1110100010100100000000000011
1111001100100010000110000011
1110110010000011000000000011
1110000101000000100010100011
1100100010100010010000000011
1110010100010001000001111111
1101100010011000000010000011
1100011000000000000000000011
1111111111111111111111111111

