NO ./src/textures/Bricks_07-128x128.png
SO ./src/textures/DarkAbstractBackgrounds_06.png
WE ./src/textures/DarkAbstractBackgrounds_09.png
EA ./src/textures/DarkAbstractBackgrounds_010.png


F  220,100,0
C 225,30,0

1111111111111111111
1000000001N00000011
1011101001001111011
1010011000010010011
1010100010100010101
1001001101000101001
1000110010011000101
1110000101000010111
1000100010100100011
1010010100010010101
1011101000100110101
1000010101000010001
1001100010111001001
1110011001000110111
1000100100100010001
1111111111111111111
