NO ./src/textures/6.png
SO ./src/textures/2.png
WE ./src/textures/3.png
EA ./src/textures/4.png
MU ./src/textures/mushr.png
MU2 ./src/textures/mushr2.png
MUM ./src/textures/mushr_map.png
DO0 ./src/textures/13.png
DO1 ./src/textures/14.png
DO2 ./src/textures/15.png
PS1 ./src/textures/psy1.png
PS2 ./src/textures/psy2.png
PS3 ./src/textures/psy3.png


F  220,100,0
C 225,30,0

1111111111111111111
1000000001N00000011
1011101001001111D11
1010011000010010011
1010100010100010101
1001001101000101001
1000110010011000101
1110000101000010111
1000100D00100100011
101001010M010010101
1011101000100110101
1000010101000010001
1001100M10111001001
1110011001000110111
1000100100100010001
1111111111111111111
