NO ./src/textures/6.png
SO ./src/textures/2.png
WE ./src/textures/3.png
EA ./src/textures/4.png
MU ./src/textures/mushr.png
MU2 ./src/textures/mushr2.png
DO0 ./src/textures/13.png
DO1 ./src/textures/14.png
DO2 ./src/textures/15.png
PS1 ./src/textures/psy1.png
PS2 ./src/textures/psy2.png
PS3 ./src/textures/psy3.png

C 91,166,252
F 224,184,144

11111111111111
111111000001
    1000001
    1111011
      1111
