NO textures/random_./src/textures/DarkAbstractBackgrounds_03.png
SO textures/random_./src/textures/DarkAbstractBackgrounds_06.png
WE textures/random_./src/textures/DarkAbstractBackgrounds_09.png
EA textures/random_./src/textures/DarkAbstractBackgrounds_010.png

C 91,166,252
F 224,184,144

1111111111111111111111111
100000000001000E000000001
1000000000000000000001111
1000000000000010100111111
11000000000001101001
1000000000000000000111111
10000000000000000000000011111
1000000000000000000000001
1000000000000000000000001
1000000000000000000000001
1111111111111111111111111
