NO ./src/textures/DarkAbstractBackgrounds_03.png
SO ./src/textures/DarkAbstractBackgrounds_06.png
WE ./src/textures/DarkAbstractBackgrounds_09.png
EA ./src/textures/DarkAbstractBackgrounds_010.png

C 91,166,252
F 224,184,144

111111111111 111111111111111
100000000001 11000E000000001
1000000000011100000000001111
1000000000000010100000001
1100000000000110100000001
1000000000000000000000001
10000000000000000000000011111
1000000000000000000000001
1000000000000000000000001
1000000000000000000000001
1111111111111111111111111
